S
50
20
WWWWWWWWWWWWWWWWWWWWWWWWWWWWWWWWWWWWWWWWWWWWWWWWWW
WGGGGGGGGGGGGGGGGGGGGGGGGGGGGGWWWWWWWWWWGGGGGGGGGG
WGGGGGGGGGGGGGGGGGGWWWGGGGGGGGGGGWWWGGGGGGGGGGGGGG
WGGGGGGGPGGGGGGGGGGWWWGGGGGGGGGGGGGGGGGGGGGGGGGGGG
WGGGGGGGPGGGGGGGGGGWWWGGGGGGGGPPPPPPPPPPPPPPGGGGGG
WGGGGGGGPPPPPPPPPPPPPPPPGGGGGGPPPPPGGGGGGGGGGGGGGG
WGGGGGGGGGGGGGGGGGGGGGGPGGGGGGPPPPPGGGGGGGGGGGGGGG
WGGGGGGGGGGGGGGGGGGGGGGPGGGGGGGGPPPGGGGGGGGGGGGGGG
WGGGGGGGPPPPPPPPPPPPPPPPGGGGGGGGGGGGGGGGGGGGGGGGGG
WGGGGGGGGGGGGGGGGGGGGGGGGGGGGGGGGGGGGGGGGGGGGGGGGG
WGGWWWWWGGGGGGGGGGGGGGGGGGGGGGPPPPPPPPPPPGGGGGGGGG
WGGWWWWWWWGGGGGGGGGGGGGGGGGGGGPPPWWWWWPPPGGGGGGGGG
WGGWWWWWWWGGGGGGGGGGGGGGGGGGGGPPPWWWWWPPPGGGGGGGGG
WGGWWWWWWGGGGGGGGGGGGGGGGGGGGGPPPWWWWWPPPGGGGGGGGG
WGGGGGGGGGGGGGGGGGGGGGGGGGGGGGPPPPPPPPPPPGGGGGGGGG
WGGGGGGGGGGGGGGGGGGGGGGGGGGGGGGGGGGGGGGGGGGGGGGGGG
WGGGGGGGGGGGGGGGGGGGGGGGGGGGGGGGGGGGGGGGGGGGGGGGGG
WGGGGGGGGGGGGGGGGGGGGGGGGGGGGGGGGGGGGGGGGGGGGGGGGG
WGGGGGGGGGGGGGGGGGGGGGGGGGGGGGGGGGGGGGGGGGGGGGGGGG
WWWWWWWWWWWWWWWWWWWWWWWWWWWWWWWWWWWWWWWWWWWWWWWWWW