S
30
20
WWWWWWWWWWWWWWWWWWWWWWWWWWWWWW
WGGGGGGGGGGGGGGGGGGGGGGGGGGGGW
WGGGGGGGGGGGGGGGGGGWWWGGGGGGGW
WGGGGGGGPGGGGGGGGGGWWWGGGGGGGW
WGGGGGGGPGGGGGGGGGGWWWGGGGGGGW
WGGGGGGGPPPPPPPPPPPPPPPPGGGGGW
WGGGGGGGGGGGGGGGGGGGGGGPGGGGGW
WGGGGGGGGGGGGGGGGGGGGGGPGGGGGW
WGGGGGGGPPPPPPPPPPPPPPPPGGGGGW
WGGGGGGGGGGGGGGGGGGGGGGGGGGGGW
WGGWWWWWGGGGGGGGGGGGGGGGGGGGGW
WGGWWWWWWWGGGGGGGGGGGGGGGGGGGW
WGGWWWWWWWGGGGGGGGGGGGGGGGGGGW
WGGWWWWWWGGGGGGGGGGGGGGGGGGGGW
WGGGGGGGGGGGGGGGGGGGGGGGGGGGGW
WGGGGGGGGGGGGGGGGGGGGGGGGGGGGW
WGGGGGGGGGGGGGGGGGGGGGGGGGGGGW
WGGGGGGGGGGGGGGGGGGGGGGGGGGGGW
WGGGGGGGGGGGGGGGGGGGGGGGGGGGGW
WWWWWWWWWWWWWWWWWWWWWWWWWWWWWW